acambaro	Mexico
acapulco	Mexico
acayucan	Mexico
aguascalientes	Mexico
apizaco	Mexico
autlan-de-navarro	Mexico
caborca	Mexico
cadereyta	Mexico
camargo	Mexico
campeche	Mexico
cancun	Mexico
cd-acuna	Mexico
cd-cuauhtemoc	Mexico
cd-del-carmen	Mexico
cd-guzman	Mexico
cd-hidalgo	Mexico
cd-juarez	Mexico
cd-nezahualcoyotl	Mexico
cd-obregon	Mexico
cd-victoria	Mexico
cdmx-centro	Mexico
cdmx-norte	Mexico
cdmx-oriente	Mexico
cdmx-poniente	Mexico
cdmx-sur	Mexico
celaya	Mexico
chalco-ixtapaluca	Mexico
chetumal	Mexico
chihuahua	Mexico
chilpancingo	Mexico
chimalhuacan	Mexico
coacalco	Mexico
coatzacoalcos	Mexico
colima	Mexico
comalcalco	Mexico
comitan	Mexico
cordoba	Mexico
cozumel	Mexico
cuautla	Mexico
cuernavaca	Mexico
culiacan	Mexico
cunduacan	Mexico
delicias	Mexico
dolores-hidalgo	Mexico
durango	Mexico
ecatepec	Mexico
emiliano-zapata	Mexico
ensenada	Mexico
garcia	Mexico
gomez-palacio	Mexico
guadalajara-centro	Mexico
guadalajara-norte	Mexico
guadalajara-norte-poniente	Mexico
guadalajara-oriente	Mexico
guadalajara-poniente	Mexico
guadalajara-sur	Mexico
guasave	Mexico
hermosillo	Mexico
hidalgo-del-parral	Mexico
huatulco-	Mexico
huauchinango	Mexico
iguala	Mexico
irapuato	Mexico
ixtlahuaca-de-rayon	Mexico
jimenez	Mexico
jiutepec	Mexico
jojutla	Mexico
la-paz	Mexico
la-piedad	Mexico
lazaro-cardenas	Mexico
leon	Mexico
linares	Mexico
los-cabos	Mexico
los-mochis	Mexico
los-reyes-la-paz-	Mexico
macuspana	Mexico
manzanillo	Mexico
martinez-de-la-torre	Mexico
matamoros-coahuila	Mexico
matamoros-tamaulipas	Mexico
mazatlan	Mexico
merida	Mexico
mexicali	Mexico
minatitlan	Mexico
monclova	Mexico
montemorelos	Mexico
monterrey-cumbres	Mexico
monterrey-centro	Mexico
monterrey-norte	Mexico
monterrey-oriente	Mexico
monterrey-sendero	Mexico
monterrey-sur	Mexico
morelia	Mexico
muzquiz	Mexico
nogales	Mexico
nuevo-laredo	Mexico
nuevo-vallarta	Mexico
oaxaca	Mexico
ometepec	Mexico
orizaba	Mexico
pachuca	Mexico
paraiso	Mexico
parras-de-la-fuente-	Mexico
patzcuaro	Mexico
perinorte-cuautitlan	Mexico
playa-del-carmen	Mexico
puebla	Mexico
puerto-penasco-	Mexico
puerto-vallarta	Mexico
queretaro	Mexico
ramos-arizpe	Mexico
reynosa	Mexico
rosarito	Mexico
sahuayo	Mexico
salamanca	Mexico
saltillo	Mexico
san-cristobal-de-las-casas	Mexico
san-francisco-del-rincon	Mexico
san-juan-de-los-lagos	Mexico
san-juan-del-rio	Mexico
san-l-rio-colorado	Mexico
san-luis-potosi	Mexico
san-pedro	Mexico
santiago-tianguistenco-de-galeana	Mexico
sayula-jalisco	Mexico
silao	Mexico
tampico	Mexico
tapachula	Mexico
taxco	Mexico
tecamac	Mexico
tecate	Mexico
tecoman	Mexico
tehuacan	Mexico
temixco	Mexico
tepatitlan	Mexico
tepeji-del-rio	Mexico
tepic	Mexico
teziutlan-puebla	Mexico
tijuana	Mexico
tizayuca	Mexico
tlajomulco	Mexico
tlaxcala	Mexico
toluca	Mexico
tonala	Mexico
torreon	Mexico
tuxpan	Mexico
tuxtepec-	Mexico
tuxtla-gutierrez	Mexico
uriangato	Mexico
uruapan	Mexico
veracruz	Mexico
villaflores	Mexico
villahermosa	Mexico
xalapa	Mexico
zacatecas	Mexico
zamora	Mexico

a-coruna	Spain
alava	Spain
albacete	Spain
alicante	Spain
almeria	Spain
asturias	Spain
badajoz	Spain
barcelona	Spain
cadiz	Spain
la-rioja	Spain
las-palmas	Spain
lugo	Spain
madrid	Spain
malaga	Spain
navarra	Spain
pontevedra	Spain
santa-cruz-tenerife	Spain
sevilla	Spain
tarragona	Spain
valencia	Spain
valladolid	Spain
vizcaya	Spain
zaragoza	Spain

guatemala-guatemala	Guatemala
jutiapa	Guatemala
mazatenango-guatemala	Guatemala
quetzaltenango-guatemala	Guatemala
san-pedro-carcha	Guatemala

san-salvador-el-salvador	El Salvador
santa-ana-el-salvador	El Salvador

cartago-costa-rica	Costa Rica
heredia-costa-rica	Costa Rica
lindora-costa-rica	Costa Rica
moravia-costa-rica	Costa Rica
san-jose-costa-rica	Costa Rica
tres-rios-costa-rica	Costa Rica

juticalpa-honduras	Honduras
san-pedro-sula-honduras	Honduras
tegucigalpa-honduras	Honduras

barrancabermeja-colombia	Colombia
barranquilla-colombia	Colombia
bogota-colombia	Colombia
cali-colombia	Colombia
chiacundinamarca-colombia	Colombia
manizales-colombia	Colombia
medellin-envigado-colombia	Colombia
valledupar-colombia	Colombia

panama-david-chiriqui	Panama
panama-panama	Panama

barueri	Brazil
bauru	Brazil
belem	Brazil
belo-horizonte	Brazil
blumenau	Brazil
campinas	Brazil
campo-grande	Brazil
carapicuiba	Brazil
cariacica	Brazil
caxias-do-sul	Brazil
cuiaba	Brazil
curitiba	Brazil
fortaleza	Brazil
goiania	Brazil
guarulhos	Brazil
itaquaquecetuba	Brazil
jaboatao-dos-guararapes	Brazil
joao-pessoa	Brazil
jundiai	Brazil
macapa	Brazil
manaus	Brazil
marilia	Brazil
natal	Brazil
olinda	Brazil
ourinhos	Brazil
porto-alegre	Brazil
ribeirao-preto	Brazil
rio-de-janeiro	Brazil
salvador	Brazil
santa-maria	Brazil
sao-bernardo-do-campo	Brazil
sao-goncalo	Brazil
sao-jose	Brazil
sao-jose-do-rio-preto	Brazil
sao-jose-dos-campos	Brazil
sao-luis	Brazil
sao-paulo	Brazil
sorocaba	Brazil
teresina	Brazil
tres-lagoas	Brazil
uberlandia	Brazil

norte-y-centro-de-chile	Chile
sur-de-chile	Chile
